XXXXXXXXXXXXXXXXXXXXXXXXXXXXXXXXXXXXXXXXXXXXXXXXXX
XS0000X00000000000000000000000X000000000000000000X
X00000X0000000000000XX00000000X0000000000000XX000X
X00X00000000000000000000000X000000000000000000000X
X00000X00000X0000XX00000000000X00000X0000XX000000X
X00000XXXXXXX00000000000000000XXXXXXX000000000000X
XX0XXXX00000X000000000000X0XXXX00000X000000000000X
X00000000000X000XXXXXXXXX00000000000X000XXXXXXXXXX
X00000000000X000000X0000000000000000X000000X00000X
XXXX00000000X000X00000000XXX00000000X000X00000000X
X00X00000000000XX00X0000000X00000000000XX00X00000X
X00X00XXXXXXX00000000XX0000X00XXXXXXX00000000XX00X
X00000000000X000X00X0000000000000000X000X00X00000X
X00000000000XXXXXX0XXXX0X00000000000XXXXXX0XXXX0XX
X000000000000000000X00000000000000000000000X00000X
X000X00000000000000X00000000X00000000000000X00000X
X000000000000000000X00000000000000000000000X00000X
X0000000X0000000000X000000000000X0000000000X00000X
X0000000XXXXXXXXXXXX000000000000XXXXXXXXXXXX00000X
X0000000X000000000X0000000000000X000000000X000000X
X0000000X000000000X0XXXXX0000000X000000000X0XXXXXX
X0000000X0000000X000000000000000X0000000X00000000X
X000000000000000X00000000000000000000000X00000000X
X0000000X0000000X0000000X0000000X0000000X00000000X
X00000X00000000000000000000000X000000000000000000X
X00000X0000000000000XX00000000X0000000000000XX000X
X00X00000000000000000000000X000000000000000000000X
X00000X00000X0000XX00000000000X00000X0000XX000000X
X00000XXXXXXX00000000000000000XXXXXXX000000000000X
XX0XXXX00000X000000000000X0XXXX00000X000000000000X
X00000000000X000XXXXXXXXX00000000000X000XXXXXXXXXX
X00000000000X000000X0000000000000000X000000X00000X
XXXX00000000X000X00000000XXX00000000X000X00000000X
X00X00000000000XX00X0000000X00000000000XX00X00000X
X00X00XXXXXXX00000000XX0000X00XXXXXXX00000000XX00X
X00000000000X000X00X0000000000000000X000X00X00000X
X00000000000XXXXXX0XXXX0X00000000000XXXXXX0XXXX0XX
X000000000000000000X00000000000000000000000X00000X
X000X00000000000000X00000000X00000000000000X00000X
X000000000000000000X00000000000000000000000X00000X
X0000000X0000000000X000000000000X0000000000X00000X
X0000000XXXXXXXXXXXX000000000000XXXXXXXXXXXX00000X
X0000000X000000000X0000000000000X000000000X000000X
X0000000X000000000X0XXXXX0000000X000000000X0XXXXXX
X0000000X0000000X000000000000000X0000000X00000000X
X000000000000000X00000000000000000000000X00000000X
X0000000X0000000X0000000X0000000X0000000X0000000GX
XXXXXXXXXXXXXXXXXXXXXXXXXXXXXXXXXXXXXXXXXXXXXXXXXX